16 12
1111111111111111
1D00000000000001
100S000000000001
1001111100000001
1000000100111111
11111001000000L1
1000000100001111
1011110100J00001
1000000100111111
1000111100000001
1000000000000001
1111111111111111