16 12
0000000000000000
0000000000000000
0000000000000000
0000000000000000
0000000000000000
S000000000000000
1111111111111111
1111111111111111
1111111111111111
1111111111111111
1111111111111111
1111111111111111