16 12
1111111111111111
1000000000000001
10D0000000000001
1000000000000001
1000000000000001
1001110000000001
1000000011100001
1000000000000001
1000000000001111
1JS00L0100000001
1111111111111111
1111111111111111